EA ./textures/ea.xpm
SO ./textures/so.xpm
WE ./textures/we.xpm

F 203,191,174
C 225,30,0

                        NO ./textures/no.xpm

1111
10N1
1001
1001
1111
