EA ./textures/ea.xpm
SO ./textures/so.xpm
WE ./textures/we.xpm

F 20,100,0
C 225,30,0

                        NO ./textures/no.xpm

1111
10S1
1001
1001
1111
