NO ./textures/no.xpm
EA ./textures/ea.xpm
SO ./textures/so.xpm
WE ./textures/we.xpm

F 20,100,0
C 225,30,0

   11
 1 1011
101011
10E1 11
 1111001
    111
