NO ./textures/no.xpm
EA ./textures/ea.xpm
SO ./textures/so.xpm
WE ./textures/we.xpm

F 203,191,174
C 169,214,255

   11
 1 1011
101011
10E1 11
 1111001
    111
