EA ./textures/ea.xpm
SO ./textures/so.xpm
WE ./textures/we.xpm

F 20,100,0
C 225,30,0

                        NO ./textures/no.xpm

111111111111
100000000001
100000000001
1000S0000001
100000000001
100000000001
111111111111
