NO ./textures/no.xpm
EA ./textures/ea.xpm
SO ./textures/so.xpm
WE ./textures/we.xpm

F 203,191,174
C 169,214,255

       1111111111111111111111111
1       1000000000110000000000001
11      1011000001110000000000001
11     1001000000000000000000001
111111111011000001110000000000001
100000000000000001110111111111111
11110111111111011100000010001
11110111111111011101011110001
1100000011010101110001 1010001
10000000000000001100001110001
10000000000000001101000000001
11000001110101011111011110N0111
11110111 1110101 101111010001
11111111 1111111 111111111111

