EA ./textures/ea.xpm
SO ./textures/so.xpm
WE ./textures/we.xpm

F 203,191,174
C 169,214,255

NO ./textures/no.xpm

111111111111
100000000001
1000S0000001
100000000001
100000011001
100000011001
1111111  111
