NO ./textures/no.xpm
EA ./textures/ea.xpm
SO ./textures/so.xpm
WE ./textures/we.xpm


FF 203,191,174
C 169,214,255

1111
10N1
1001
1001
1111
