EA ./path_to_the_east_texture
SO ./path_to_the_south_texture
WE ./path_to_the_west_texture
NO ./path_to_the_north_texture

F 20,100,0
C 225,30,0

111111
1 N0 1
1    1
111111
