WE ./path_to_the_west_texture
SO ./path_to_the_south_texture
NO ./path_to_the_north_texture
EA ./path_to_the_east_texture

F 203,191,174
C 169,214,255

       1111111111111111111111111
1       1000000000110000000000001
11      1011000001110000000000001
11     1001000000000000000000001
111111111011000001110000000000001
100000000011000001110111111111111
1000000000000000000000000000000011111111111111111111
1111011111111101110000001000000000000000000000000001
1111011111111101110101111000000000000000000000000001
1100000011010101110001 10100011111111111111111111111
10000000000000001100001110001
10000000000000001100001110001	1111111111111111
10000000000000001100001110001   1000000000000001
10000000000000001100001110001   0000000000000001
10000000000000001101010010001   1111111111111111
10000000000000001100001110001
11000001110101011111011110N01111111111111111111111111
11110111 1110101 101111010000000000000000000000000001
11111111 1111111 111111111111111111111111111111111111
