NO ./textures/no.xpm
EA ./textures/ea.xpm
SO ./textures/so.xpm
WE ./textures/we.xpm

F 203,191,174
C 169,214,255

111111
000001
100N01
100001
111111
