NO ./textures/no.xpm
EA ./textures/ea.xpm
SO ./textures/so.xpm
WE ./textures/we.xpm

F 20,100,0
C 225,30,0

111111
100001
1000h1
100001
111111
