EA ./path_to_the_east_texture
SO ./path_to_the_south_texture
WE ./path_to_the_west_texture
NO ./path_to_the_north_texture

F 20,100,0
C 225,30,0

111111
000001
100N01
100001
111111
