EA ./path_to_the_east_texture
SO ./path_to_the_south_texture
WE ./path_to_the_west_texture
NO ./path_to_the_north_texture

F 20,100,-1
C 280,30,0

1111
10N1
1001
1001
1111
