1111
10N1
1001
1001
1111

NO ./textures/no.xpm
SO ./textures/so.xpm
EA ./textures/ea.xpm
WE ./textures/we.xpm

F 20,100,10
C 255,30,0
